Z	Z
Zv	Zv
Zd	Zd
Zx	Zx
Zy	Zy
Ze	Ze
Zw	Zw
Zq	Zq
N	N
Nv	Nv
Nd	Nd
Nx	Nx
Ny	Ny
Ne	Ne
Nw	Nw
Nq	Nq
_d	_d
Ar	Ar
Ax	Ax
V	V
Vd	Vd
Ve	Ve
Dd	Dd
Cd	Cd
Cr	Cr
Mv	Mv
Md	Md
Mx	Mx
Mw	Mw
T	T
Td	Td
Te	Te
Tq	Tq
O	O
F	F
G	G
E	E
K	K
L	L
Q	Q
H	H
J	J
#NOME?	#NOME?
#NOME?	#NOME?
#NOME?	#NOME?
#NOME?	#NOME?
#NOME?	#NOME?
#NOME?	#NOME?
#NOME?	#NOME?
#NOME?	#NOME?
#NOME?	#NOME?
#NOME?	#NOME?
\	\
.	.
|	|
:	:
"	"	"	"
#NOME?	#NOME?
#NOME?	#NOME?
